La enmienda n.º 7 propone ciertos cambios en las referencias a los párrafos.	Amendment 7 changes in references to paragraphs.	4.5
have a great affection, liking, or desire for	sentir un gran afecto o simpatía por.	5.0
el extremo positivo de la batería y el terminal 1 no están conectados	Terminal 1 and the positive terminal are not connected	5.0
Russia finds dead lawyer Magnitsky guilty in posthumous trial	Rusia declara culpable al abogado Magnitsky en juicio póstumo	5.0
11 killed in Chinese police station attack	Once muertos en ataque a una comisaría en China	5.0
A black dog with a blue collar is running in the snow.	Un perro negro con un collar azul está corriendo en la nieve.	5.0
Value measured by what must be given or done to obtain something.	valor medido por lo que debe darse o hacerse o sufrirse para obtener algo.	4.75
Un hombre está tocando la batería.	A man plays the drum.	5.0
Las bombillas A y C todavía estaban contenidas en circuitos cerrados con la batería	Bulbs A and C are still contained in closed paths with the battery	4.6
Tren en una estación.	a train in a station.	5.0
Hurricane Sandy Closes in on US East Coast	El huracán Sandy amenaza la costa este de Estados Unidos	4.8
the blub is not contained in the same closed path as the battery	La bombilla no está en el circuito cerrado que contiene la batería	5.0
Es más, las divisiones se reproducen a nivel local.	Beyond the geographical division, the divisions occur at local level.	4.5
Esa disposición podría abrir las puertas de la arbitrariedad.	This point of the rules of procedure opens the door to the arbitrary.	4.5
That is the spirit in which the European Constitution must be written.	Ese es el espíritu con el que debe resolverse la Constitución Europea.	4.5
The man is riding a horse.	Un hombre está cabalgando.	5.0
A man and a dog on rocks on a beach.	Un hombre y un perro en una costa rocosa.	4.6
The fishermen are inactive, tired and disappointed.	Los pescadores están desempleados, cansados y decepcionados.	4.75
Las fuerzas israelíes detienen a cinco palestinos en Cisjordania	Israeli Forces Arrest Five Palestinians across West Bank	4.8
The man is playing the guitar.	Un hombre está tocando la guitarra.	4.909
Esa disposición podría abrir las puertas de la arbitrariedad.	This point of the payment opens the door with the arbitrary one.	3.5
Es más, las divisiones se reproducen a nivel local.	Beyond the geographical division, divisions recur locally.	4.0
El hombre agujereó la madera.	A man drills wood.	4.2
Man standing in front of silver train.	Hombre parado frente a un vagón plateado.	4.4
A woman with a white horse.	Una mujer que dirige a un caballo blanco.	3.8
Massive Hurricane Sandy bears down on U.S. East Coast	El huracán Sandy amenaza la costa este de Estados Unidos	4.4
In the last three weeks, progress has been made in three major areas.	En las últimas semanas, se ha conseguido tres progresos importantes.	3.571
Dozens die as clashes erupt at Morsi rally in Cairo	Más de 70 muertos por enfrentamientos ocurridos en concentraciones de apoyo a Morsi en Egipto	3.6
¿El ministro Clarence Thomas rompe el silencio en un artículo de The New York Times o the Onion? No está claro.	Justice Thomas Breaks His Silence in Court	4.2
Una oveja sobre una mesa en una subasta.	Woolly sheep at auction house.	4.2
a problem, something wrong	un problema.	4.0
Someone is playing piano.	Una persona está tocando el piano eléctrico.	3.6
Una mujer está cortando un huevo duro.	A person is cutting a boiled egg into pieces.	3.533
Un hombre está tocando la guitarra.	A man is singing while playing the guitar.	3.6
Un perro negro mojado con un collar rojo está en el río	A black dog with a red collar wading through the water.	4.0
Tren en una estación.	Trains inside an indoor station.	3.8
Iran will attack Tel Aviv if Israel strikes	Clérigo superior: Irán atacará Tel Aviv si Israel ataca	4.4
reaccionar, o responder a una llamada, orden o estímulo	react to a stimulus or command.	4.2
Un tren Amtrak de pasajeros espera en una estación.	A passenger train waiting in a station.	4.0
Are all on separate paths	A y C están en circuitos distintos	3.6
because bulb c is not included in the closed path	Hay un circuito cerrado con A y B en el que no está C.	3.4
Un hombre está tocando la guitarra.	A woman is playing the guitar.	2.75
Dolce and Gabbana convicted of tax evasion	Dolce & Gabbana recibe una multa en una causa tributaria en Italia	3.0
pasar la lengua, levantar con la lengua	pass the tongue over.	3.25
The bird is sitting on the branch.	Un pájaro rojo y marrón está posado en una rama.	3.2
A horse rider is riding a white horse.	Una mujer que dirige a un caballo blanco.	3.4
reach a destination or goal	llegar a un destino; llegar por movimiento o progreso.	3.4
A pug dog wits on a yellow chair next to a green dumpster.	Un bulldog sentado en una silla amarilla al lado de un contenedor grande de basura.	3.2
Motor Racing: Button fastest in year's first F1 practice	Botón con el mejor tiempo después de la primera práctica	3.0
Una mujer hierve huevos.	A woman places two eggs into a pot of water.	3.0
the bulb is not contained in the path	La bombilla no está en el circuito cerrado que contiene la batería	3.33
Ha muerto el hombre que se inmoló en llamas en National Mall	Man Sets Himself on Fire on National Mall, Flown to Hospital	3.0
Israel inicia el ataque aéreo en la Franja de Gaza	Israel launches air strikes near Damascus	3.0
A young blonde girl wearing a helmet sits with a red bicycle behind her.	Una niña que lleva puesto un casco con una bicicleta de fondo.	3.4
A white animal running through snow covered woods.	Un perro blanco corre a través de un bosque nevado.	3.4
Un hombre está cabalgando.	A girl is riding a horse.	2.6
Bulb A, bulb B and bulb C are in different closed paths.	A y C están en circuitos distintos	3.0
Music Industry Pays Tribute to Whitney Houston	La industria de la música llora a Whitney Houston	3.4
Un muchacho montado en un caballo blanco.	A man riding a white horse in an arena.	3.2
You can find where there is a gap.	La medición del voltaje indica si entre dos terminales hay una separación.	2.6
